7,7,7,7,7,7,7,7,7,7,7,7
7,7,7,7,5,3,9,7,7,7,7,7
7,7,7,7,9,9,9,7,7,7,7,7
7,7,7,7,9,9,9,7,7,7,7,7
7,7,9,9,9,9,9,9,9,7,7,7
7,7,9,9,9,9,9,9,9,7,7,7
7,7,9,9,9,9,9,9,9,7,7,7
7,7,9,9,9,9,9,9,9,7,7,7
7,7,8,9,9,9,9,9,9,7,7,7
7,7,7,7,9,9,9,7,7,7,7,7
7,7,7,7,9,9,4,7,7,7,7,7
7,7,7,7,7,7,7,7,7,7,7,7
