7,7,7,7,7,7,7,7,7,7,7,7
7,7,7,7,7,7,7,7,1,1,4,7
7,7,7,7,7,7,7,7,1,1,1,7
7,7,7,7,7,7,7,7,1,1,1,7
7,7,7,7,7,7,7,7,1,1,1,7
7,7,7,7,7,7,7,7,1,1,1,7
7,1,1,1,1,1,1,1,1,1,1,7
7,1,1,1,1,1,1,1,1,1,1,7
7,1,1,1,1,1,1,1,1,1,1,7
7,3,1,1,1,1,1,1,1,1,1,7
7,7,7,7,7,7,7,7,7,7,7,7
7,7,7,7,7,7,7,7,7,7,7,7