2,2,2,2,2,2,2,2,2,2,2,2
2,1,3,1,1,1,1,1,1,1,1,2
2,1,1,1,1,1,1,1,1,1,1,2
7,7,7,7,7,7,7,7,1,1,1,2
2,1,1,1,1,1,1,1,1,1,1,2
2,1,1,1,1,1,1,1,1,1,1,2
2,1,1,1,1,1,1,1,1,1,1,2
2,1,1,1,7,7,7,7,7,7,7,7
2,1,1,1,1,1,1,1,1,1,1,2
2,1,1,1,1,1,1,1,1,1,1,2
2,1,1,1,1,1,1,1,1,1,4,2
2,2,2,2,2,2,2,2,2,2,2,2
