2,2,2,2,2,2,2,2,0,0,0,0
2,5,3,1,1,1,1,1,2,0,0,0
2,1,1,1,1,1,1,1,1,2,0,0
2,1,1,1,1,1,1,1,1,1,2,0
2,1,1,1,1,1,1,1,1,1,2,0
0,2,1,1,1,1,1,1,1,1,1,2
0,0,2,1,1,1,1,1,1,1,1,2
0,0,0,2,1,1,1,1,1,1,1,2
0,0,0,0,2,1,1,1,1,1,1,2
0,0,0,0,0,2,1,1,1,1,1,2
0,0,0,0,0,0,2,1,1,1,4,2
0,0,0,0,0,0,7,2,2,2,2,0