7,7,7,7,7,7,7,7,7,7,7,7
7,7,7,7,7,7,5,3,1,7,7,7
7,7,7,7,7,7,1,1,1,7,7,7
7,7,7,7,7,7,1,1,1,7,7,7
7,1,1,1,1,1,1,1,1,7,7,7
7,1,1,1,1,1,1,1,1,7,7,7
7,1,1,1,1,1,1,1,1,7,7,7
7,1,1,1,7,7,7,7,7,7,7,7
7,1,1,1,1,1,1,1,1,1,1,7
7,1,1,1,1,1,1,1,1,1,1,7
7,1,1,1,1,1,1,1,1,1,4,7
7,7,7,7,7,7,7,7,7,7,7,7