7,7,7,7,7,7,7,7,7,7,7,7
7,7,7,7,5,3,6,7,7,7,7,7
7,7,7,7,6,6,6,7,7,7,7,7
7,7,7,7,6,6,6,7,7,7,7,7
7,7,6,6,6,6,6,6,6,7,7,7
7,7,6,6,6,6,6,6,6,7,7,7
7,7,6,6,6,6,6,6,6,7,7,7
7,7,6,6,6,6,6,6,6,7,7,7
7,7,8,6,6,6,6,6,6,7,7,7
7,7,7,7,6,6,6,7,7,7,7,7
7,7,7,7,6,6,4,7,7,7,7,7
7,7,7,7,7,7,7,7,7,7,7,7