7,7,7,7,7,7,7,7,7,7,7,7
7,6,3,6,6,6,6,6,6,6,6,7
7,6,6,6,6,6,6,6,6,6,6,7
7,6,6,6,6,6,6,6,6,6,6,7
7,7,7,7,7,7,7,7,6,6,6,7
7,7,7,7,7,7,7,7,6,6,6,7
7,7,7,5,11,6,6,6,6,6,6,7
7,7,7,11,6,6,6,6,6,6,6,7
7,7,7,6,6,6,6,6,6,6,6,7
7,7,7,6,6,6,6,6,6,6,6,7
7,7,7,6,6,6,6,6,4,7,7,7
7,7,7,7,7,7,7,7,7,7,7,7